8 8 30
VV121VVV
VVVVVVVV
VJLVVV1V
V121JLVV
VVVVVVVV
VJKLVVVV
VPVVVVVZ
BBBCWWWW
Back.png
